##########
# .S.....#
# ###.##.#
# # ...#.#
# # .#.#.#
# ##.#####
# # .....#
# # #..#.#
#####.####
#   #....#
# #    #E#
##########
