#######################################
#E......              #     #         #
#######.############# ##### ######### #
#     #...#....                       #
# ### ###.###.#########################
#     #...#...#...#...........        #
### # # #.#.#.#.#.#.###.###############
#.# #   #...#...#...#.#.#...# #       #
#.###################.#.#.#   ####### #
#.#...#...#.#.#.......#.#.###         #
#.#.#.#.#.#.#.#.#######.#...######### #
#.#.#.#.#.#.#...#.......###.#         #
#...#.#.#.#.#.#.#.#######...# #########
#.#.#...#...#.#.#.#.......#.#         #
#.#.#########.#.#.#.#######.# ####### #
#S#.................#       #         #
#######################################
